111111
11P001
100011
11E0C1
111111
