11111111111111
1P00E000000001
101000010C0001
11000110110001
1100100C000001
11000101010001
11111110111111
1111111C111111
11111111111111