11111111
10000001
1P0000C1
10000E01
11111111