1111111111
1P100010C1
101C001001
1000000001
1111100111
10000C0001
100100C111
1001000101
1C010000E1
1111111111